{
  "name": "Greyfield Keep",
  "vision": 2,
  "grid": [
    ["2","2","2","2","2","2","2","2","2","2","2","2","2","2","2","2","2","2","2","2"],
    ["2","1","1","1","1","1","1","1","1","1","1","1","1","1","1","1","1","1","1","2"],
    ["2","1","2","2","2","2","2","2","2","1","1","2","2","2","2","2","2","2","1","2"],
    ["2","1","2","1","1","1","1","1","2","1","1","2","1","1","1","1","1","2","1","2"],
    ["2","1","2","1","4","1A","4","1","2","1","1","1","1","1","1","1","1","2","1","2"],
    ["2","1","2","1","5","5","1","1","2","1","1","2","1","1","1","1","1","2","1","2"],
    ["2","1","2","1","1","1","1","1","2","1","1","2","2","2","2","2","2","2","1","2"],
    ["2","1","2","2","2","1","2","2","2","1","1","1","1","1","1","1","1","1","1","2"],
    ["2","1","1","1","1","1","1","1","1","1","1","1","1","1","1","1","1","1","1","2"],
    ["2","1","1","1","1","1","1","1","1","2","1","1","1","1","1a","1","1","1","1","2"],
    ["2","1","1","1","1","1","1","1","2","2","2","1","1","1","1","1","1","1","1","2"],
    ["2","1","1","1","1","1","1","1","1","2","1","2","2","2","1","2","2","2","1","2"],
    ["2","1","2","2","1","2","2","2","1","1","1","2","1","1","1","1","1","2","1","2"],
    ["2","1","2","1","1","1","1","2","1","1s","1","2","1","1","1","1","1","2","1","2"],
    ["2","1","2","1","1","1","1","2","1","1","1","1","1","1","1b","1","1","2","1","2"],
    ["2","1","2","1","1","1","1","2","1","1","1c","2","1","1","1","1","1","2","1","2"],
    ["2","1","2","1","1","1","1","2","1","1","1","2","1","1","1","1","1","2","1","2"],
    ["2","1","2","2","2","2","2","2","1","1","1","2","2","2","2","2","2","2","1","2"],
    ["2","1","1","1","1","1","1","1","1","1","1","1","1","1","1","1","1","1","1","2"],
    ["2","2","2","2","2","2","2","2","2","2","2","2","2","2","2","2","2","2","2","2"]
  ],
  "scripts": {
    "a": ["d","g","s","h","a","f","w","t"],
    "b": ["a","f","w","t","d","g","s","h"],
    "c": ["w","t","d","g","s","h","a","f"],
    "s": ["d","a",".","."]
  }
}
